1115000000555555000000000000055555550000
1115555555511115000000000000051111150000
1111111111311115555555555555055555150000
5555555155511111111111111115555555150000
0555555150555555555555111111111111150000
0511111150000000051113111115555555150000
0555155550555555551555555555000051150000
5555155555511111111500000000000051550000
5111111111115555555500000000000051500000
5155155555515555555555555555555551500000
5111150000511111111111111111111111500000
5555555555515555555555555555555555500000
0000005111111111500000000000000000000000
0000005111111111555555555555000000000000
0000005111111111111111111115000000000000
0005555555555555555555545555555555555000
0005111111111111111111111111111111115000
0005155555555555555555515555555555515000
0005150000000000005111111111500000515000
0005150000555555555155555551555555545550
0005150000511111111150000051111111311150
0005155555515555555155555551555555511150
0005111111315555555111111111500000511150
0005555555511111155155555555500000556550
0000000000555555111150000000000000000000
