1115550555555555555555552222222555555550
1111150511111111111111152225555515515155
1115150512155555555555152225111111111115
5155155512155555551115155555155555151515
5111111111111111151113111111150005555555
5155555155551215551115155555150000000000
5155551115051211555555150005150555555500
5111151115051221311111150005150511111500
5555151115051111555155550005155511111555
0511155455555555505150000005113111111115
0515555111555000005150000005155511111515
0511115551125200005155555555150511111515
0515515051115220005155111155150555555515
0555115051115222005155111113150000000515
0555155555515555555113111155550000000515
0511150511111111111155112115555555555515
0545550555555515555151122225111111111115
0511500000005515005151222255155555554555
0551555550005115005155555555152222511155
0051111150055155555111111111152225512115
0051111155551111155555555555152115112215
0051111111111555455115000005131155122115
0051111155555551111115000005551151121115
0051111152222511111155000000611152221115
0055555552222555555555000000555555255555