1115555555555555555555555555555555555555
1111111111111111111111111111111111111115
1115555455555155555555555555555555545515
5155555150005115511111111111111111115515
5113111150005511555515555555555555515515
5155111550000551111515055555555555511315
5155111500000055111515051111111115551515
5155555555500005111515551555555515551515
5111111111500005545511551511111511551515
5155555551500055515551551511111551551515
5151111151500051111151551555156551551515
5151555151555551111151551111155551551515
5151515151113111111151555555555551551515
5151511151555551111151500511111111551515
5151555551500051111151555545555555551515
5151111111500055555551111115555555551515
5155555555500000000555555511111111111515
5113111555555000000511111555555155555515
5155111111115555555511111111115151111515
5155111555511111111111111555515551551515
5155555500511155555511111111515111551515
5150000000511150000511111554511155511515
5155555555555555555555555551555555555515
5111111111111111111111111111111111111115
5555555555555555555555555555555555555555