1115555555555555555555555555555555555555
1111111151111111511111511111111111521155
1111555151555151515151555155555551521155
5111515151522251315151115111511111521155
5554515151520251555155515554515555521155
5151115111522251115151111111515111111155
5151515555515551115155512155515155555155
5151511111515111115111511150015151511155
5151555151515555515151515155515151515555
5111511151111111515151515111513151115055
5155515551555551515151515551555551555055
5111511151115111511111115151115111511055
5551555155555455555155555155555551555055
5111515152222222565111115111111151511055
5155515152222222505555555455555151515055
5151115152222222500000000051111151115055
5151515554555555555552555551555555555055
5151511111111111111152511111511111111055
5155515555555155555154515555512222215555
5111515111115151115111115111111111115155
5551515155555151555554555155555555555155
5151511151111151111151111151115111511155
5151555551555551515551555551515100000155
5111111111511111511111111111511100000155
5555555555555555555555555555555555555555
