1115555555555555555555555555555555555555
1113111111111111555555551111111115555555
5515555555555551555555555551111115555555
5515555555555551555555555555555455555555
5515555555555551555555555555555155555555
5515555555555550000001111111111155555555
5515555555555555000005555555555555555555
5515555555555555555000555555555555555555
5515555555555555555520055555555555555555
5515555555555555555515555555555555555555
5515555555555555555515555555555555555555
5511111111222222221115555555555555555555
5555155555222222225555555555555555555555
5555155555555552222222200065555555555555
5555155555522222555555555555555555555555
5555155555555511555555555555555555555555
5555111111555551111111111111111115555555
5555555551555551555555555555555515555555
5555555551555555555555555551111315555555
5555555551555555555555555551555515555555
5555555551555555555555555551500515555555
5555111111555555555555555551500515555555
5555515555511155555555555554555515555555
5555511111111155555111111111111115555555
5555555555555555555555555555555555555555