1115555555555555555555555555555555555555
1111111111151111115151111111151111115515
5115555555155115151151555555111555515115
5111111115111115155151511115111511111115
5555555515555551555551515515555515555555
5111511115111151111151511151111511111515
5151115555155555551151551555511551111515
5151115115111111111151111151511511515515
5151111111155555555555551151115515551515
5155555555555155111515111555555555515515
5111511115111511515111511115111511151115
5551511515155155155115555515551555515555
5555555555555555555555555555555555555555
5555555555555555555555555555555555555555
5555555555555555555555555555555555555555
5555555555555555555555555555555555555555
5555555555555555555555555555555555555555
5555555555555555555555555555555555555555
5555555555555555555555555555555555555555
5555555555555555555555555555555555555555
5555555555555555555555555555555555555555
5555555555555555555555555555555555555555
5555555555555555555555555555555555555555
5555555555555555555555555555555555555555
5555555555555555555555555555555555555555