1115555555555555111111111115555555555000
1110101001111100111111111111101111005000
5111111100100110111111111111001011105000
5000010111000100111111111111101001005000
5101011011011101111111111111100110015000
5111001100101000111111111110010110015000
5111100011011000111111111111110011015000
5111110001001111111111111110110011105000
5110001001101111111111111111011000015000
5110110110001111111111111110111101115000
5100111111111111111111111111111110015000
5111111111111111111111110111101001115000
5101111111111111111111100011001000015000
5010111111111111111111100011101100115000
5110111111111111111111111000100000115000
5011111111111111111111100011000011015000
5110111111111111111111111110000111105000
5000111111111111111111110011001111005000
5100111111111111111111100101110111005000
5111111111111111111111101000101100015000
5110111111111111111111101110100011015000
5001001010001111111111110100100010015000
5010011100111111111111110111111010115000
5010011101011111111111101001011110105000
5555555555555555555555555555555555555000